14 14 14 14 14 14 14 14 14 14 14 14 14 14 14 14
12 12 12 12 12 12 12 12 12 12 11 11 11 11 11 13
12 11 10 10 10 10 10 10 10 10 10 10 10 10 11 13
12 10 10 10 10 10 10 10 10 10 10 10 10 10 11 13
12 10 10 10 10 10 10 10 10 10 10 10 10 10 11 13
12 10 10 10 10 10 10 10 10 10 10 10 10 10 11 13
12 10 10 10 10 10 13 13 13 10 10 10 10 10 11 13
12 10 10 10 10 10 13 13 13 10 10 10 10 10 11 13
12 10 10 10 10 10 13 13 13 10 10 10 10 10 11 13
12 10 10 10 10 10 10 10 10 10 10 10 10 10 11 13
12 11 10 10 10 10 10 10 10 10 10 10 10 10 11 13
12 11 10 10 10 10 10 10 10 10 10 10 10 10 11 13