50 42 42 42 42 42 42 42 42 42 42 42 42 42 42 42 42 42 42 42 42 42 42 42 51
43 30 30 30 30 30 30 21 10 10 10 10 10 10 10 10 10 10 10 10 10 10 10 10 45
43 30 10 10 10 10 30 21 10 10 10 10 10 10 10 10 10 10 10 10 10 10 10 10 45
43 30 10 10 10 10 30 21 10 10 10 13 10 10 10 10 10 10 10 10 10 10 10 10 45
43 30 10 10 10 10 30 25 20 20 20 23 20 20 20 20 20 20 20 20 20 20 20 62 45
43 30 30 32 30 30 30 21 10 10 10 21 60 60 61 61 61 60 62 62 10 10 10 10 45
43 20 20 22 20 20 20 24 10 10 10 21 60 60 10 10 10 10 10 10 10 10 10 10 45
43 10 10 10 10 10 10 10 10 10 10 10 60 60 10 10 10 10 10 10 10 10 10 10 45
43 10 10 10 10 10 10 10 10 10 10 21 60 10 10 10 10 10 10 10 10 10 10 10 45
43 10 10 10 10 10 10 10 10 10 11 21 60 10 10 10 10 10 10 10 10 10 10 10 45
43 10 10 10 13 10 10 10 10 10 10 21 60 10 10 10 10 10 10 10 10 10 10 10 45
43 10 10 10 10 10 10 10 10 10 10 21 60 10 10 10 10 10 10 10 10 10 10 10 45
43 10 10 10 10 10 11 10 10 20 20 22 13 10 10 11 10 10 10 10 10 10 10 10 45
43 10 10 10 10 10 10 10 10 10 10 10 10 10 10 10 10 10 10 10 10 10 10 10 45
43 10 10 10 10 10 10 10 10 10 10 10 10 10 10 10 10 10 10 10 10 10 10 10 45
43 10 10 10 10 10 10 10 10 10 10 10 10 10 10 10 10 10 10 13 10 10 10 10 45
43 10 10 10 10 10 10 10 10 10 10 10 10 10 10 10 10 10 10 10 10 10 10 10 45
43 10 10 10 10 10 10 10 10 46 44 44 44 44 44 47 10 10 10 10 10 10 10 10 45
43 10 10 10 10 10 10 10 10 45 41 40 40 41 41 43 10 10 10 10 10 10 10 10 45
43 10 10 10 10 10 10 10 10 45 40 41 41 40 40 43 10 10 10 10 10 10 10 10 45
43 10 10 10 10 10 10 10 10 45 40 41 40 41 40 43 10 10 10 10 10 10 10 10 45
43 10 10 10 10 10 10 10 10 48 42 42 42 42 42 49 10 10 10 10 10 10 10 10 45
43 10 10 10 10 10 10 10 10 10 10 10 10 10 10 10 10 10 10 10 10 10 10 10 45
43 10 10 10 10 10 10 10 10 10 10 10 10 10 10 10 10 10 10 10 10 10 10 10 45
52 44 44 44 44 44 44 44 44 44 44 44 44 44 44 44 44 44 44 44 44 44 44 44 53